############################
#..........................#
#.###.####.######.####.###.#
#.###.####.######.####.###.#
#.......##.######.##.......#
#.#####.##.######.##.#####.#
#.#####..............#####.#
#.#####.############.#####.#
#.##....############....##.#
#.##.##..............##.##.#
#.##.##.############.##.##.#
#.##.##.############.##.##.#
#.##.##.############.##.##.#
#.##.##.############.##.##.#
#..........................#
#.####.#####.##.#####.####.#
#.####.#####.##.#####.####.#
#.####.#####.##.#####.####.#
#......#####.##.#####......#
#.####.#####.##.#####.####.#
#.####.......##.......####.#
#.####.#####....#####.####.#
#.####.#####.##.#####.####.#
#............##............#
#.##.#######.##.#######.##.#
#.##.#######....#######.##.#
#.##.........##.........##.#
#.##.#####.######.#####.##.#
#.##.#####.######.#####.##.#
#..........................#
############################
