############################
#............##............#
#.####.#####.##.#####.####.#
#.####.#####.##.#####.####.#
#.####.#####.##.#####.####.#
#..........................#
#.####.##.########.##.####.#
#.####.##.########.##.####.#
#......##....##....##......#
######.##### ## #####.######
######.##### ## #####.######
######.##          ##.######
######.## ######## ##.######
######.## ######## ##.######
          ########          
######.## ######## ##.######
######.## ######## ##.######
######.##          ##.######
######.## ######## ##.######
######.## ######## ##.######
#............##............#
#.####.#####.##.#####.####.#
#.####.#####.##.#####.####.#
#...##................##...#
###.##.##.########.##.##.###
###.##.##.########.##.##.###
#......##....##....##......#
#.##########.##.##########.#
#.##########.##.##########.#
#...........G..............#
############################